100N01
100101
101001
1100N1
111111